XXXXXXXXXXXXXXXXXXXXXXXXXXXXXXXXXXXXXXXXXXXXXXXXXXXXXXXXXXXXXXXXXXXXXXXXXXXXXXXXXXXXXXXXXXXXXXXXXXXXXXXXXXXXXXXXXXXXXXX
X                                                                                                                    RX
X                                                                                                                     X
X                     XXXXXXXXXXXXXXXXXXXXXXXXXXXXXXXXXXXX                                                            X
XXX            XX                                        X                                                            X
X               XX                                       X                                                            X
X                XX                                      X                                                            X
X                 XX                                     X                                                            X
X                  XX                                    XXXXXXXXXXXXXXXXXXXXXXXXXXXXXXXXXXXXXXXXXXXXXXXXXXXX         X
X                   XX                                   X                                                           XX
X                    XX                                  X                                                            X
X                     XXXXXXXXXXXXXXXXXXXXXXXXXXX        X                                                            X
X                                                        X                                                            X
X                                                        XA                                                        XXXX
X                                                        XXX                                                          X
X                                                      XXX                                                            X
X                                                        X                                                            X
X                                                        X        XXXXXXXXXXXXXXXXXXXXXXXXXXXXXXXXXXXXXXXXXXXXXXXXXXXXX
X                                            XXX         X                                                          ARX
X                                                        X                                                            X
X                                                        XXXX                                                         X
X                                  XXX                   X                                                            X
X                                                        X                                                            X
X                                                        X        XXXXXXXXXXXX                                        X
X                        XXX                             X                                                            X
X                                                        X                                                            X
X                                                        X                          XXXXXXXXXXXX                   XXXX
XXXXXXXXXXXXXXXXXX                                       X                                                         X  X
X                                                        X                                                       XXX  X
X                                                        X                                                            X
X                       XXXXXXXXXXXXXXXXX                X                   XXXXXXXXXXXXXXXXXXX                      X
X                                                        X                         X           X                      X
X                                                       RX                         X           X                      X
X                                             XXXXXXXXXXXXXXXXXXXXXXXX             X           XXXXXXXXXXXXXXXXXXXXXXXX
X                                                        X                         X               X                  X
X                                                        X                  XXXXXXXX               P                  X
X                                       X                X                                         P                  X
X                                      XX                X                                         P                  X
X                                     XXX               AX                                         P                  X
XXXXXXXXXXXXXXXXXXXXXXXXXXXXXXXXXXXXXXXXXXXXXXXXXXXXXXXXXXXXXXXXXXXXXXXXXXXXXXXXXXXXXXXXXXXXXXXXXXXXXXXXXXXXXXXXXXXXXXX