X                                                                                                                                                                                                                                                                                                                                                                                                                       X
X                                                                                                                                                                                                                                                                                                                                                                                                                       X
X                                                                                                                                                                                                                                                                                                                                                                                                                       X
X                                                                                                                                                                                                                                                                                                                                                                                                                       X
X                                                                                                                                                                                                                                                                                                                                                                                                                       X
X                                                                                                                                                                                                                                                                                                                                                                                                                       X
X                                                                                                                                                                                                                                                                                                                                                                                                                       X
X                                                                                                                                                                                            Q                                                                                                                                                                                                                          X
X                                                                                                                                                                                        XXXXXX                                                                                                                                                                                                                         X
X                                                                                                                                                                                                                                                                                                                                                                                                                       X
X                                                                                                                                                                              Q                                                                                                                                                                                                                                        X
X                                                                                                                                                                            XXXXXX                                                                                                                                                                                                                                     X
X                                                                                                                                                                                                                                                                                                                                                                                                                       X
X                                                                                                                                                                     P                                                                                                                                                                                                                                                 X                                                                                                                                                                                                                                                                                                                                                                                                                       X
X                                                                                                                                                                 XXXXXX                                                                                                                                                                                                                                                X
X                                                                                                                                                                                                                                                                                                                                                                                                                       X
X                                                                                                                                                                                                                                                                                                                                                                                                                       X
X                                                                                                                                                      XXXXXX                                                                                                                                                                                                                                                           X
X                                                                                                                                                                                                                                                                                                                                                                                                                       X
X                                                                                                                                         X   Q                                            X           X                                                                                                                                                                                                               PX
X                                                       XX                                                            XX                  XXXXXXXXX                                        X           X                                                     X                                                            X                                                                                     XXXXXXXXX
X                                                       XX                                                            XX                                                                   X           X                                                    XX                                                            XX                                                                                            X
X                                                       XX                                                            XX                                                                   X           X                                                  XXXX                                                            XXXX                                                                                          X
X                                                       XX                            Q                        Q      XX                 Q                     Q                           XW     I   WX                             Q                  XXXXXX                    R                   R                   XXXXXXT     W                 R               Q            W                          T      OX
XXXXXXXXXXXXXXXXXXXXXXXXXXXXXXXXXXXXXXXXXXXXXXXXXXXXXXXXXXXXXXXXXXXXXXXXXXXXXXXXXXXXXXXXXXXXXXXXXXXXXXXXXXXXXXXXXXXXXXXXXXXXXXXXXXXXXXXXXXXXXXXXXXXXXXXXXXXXXXXXXXXXXXXXXXXXXXXXXXXXXXXXXXXXXXXXXXXXXXXXXXXXXXXXXXXXXXXXXXXXXXXXXXXXXXXXXXXXXXXXXXXXXXXXXXXXXXXXXXXXXXXXXXXXXXXXXXXXXXXXXXXXXXXXXXXXXXXXXXXXXXXXXXXXXXXXXXXXXXXXXXXXXXXXXXXXXXXXXXXXXXXXXXXXXXXXXXXXXXXXXXXXXXXXXXXXXXXXXXXXXXXXXXXXXXXXXXXXXXXXXXXXXXXXX