XXXXXXXXXXXXXXXXXXXXXXXXXXXXXXXXXXXXXXXXXXXXXXXXXXXXXXXXXXXXXXXXXXXXXXXXXXXXXXXXXXXXXXXXXXXXXXXXXXXXXXXXXXXXXXXXXXXXXXX
X                                                                                                                    RX
X                                                                                                                     X
X Z                   XXXXXXXXXXXXXXXXXXXXXXXXXXXXXXXXXXXX                                                            X
XXX            XX                                        X                                                            X
X               XX                                       X                                                            X
X                XX                                      X                                                            X
X                 XX                                     X                         E                        X         X
X                  XX                                    XXXXXXXXXXXXXXXXXXXXXXXXXXXXXXXXXXXXXXXXXXXXXXXXXXXX         X
X                   XX                                   X                                                           XX
X                    XX                                  X                                                            X
X                     XXXXXXXXXXXXXXXXXXXXXXXXXXX        X                                                            X
X                                                        X                                                            X
X                                                        XA                                                        XXXX
X Z                                                      XXX                                                          X
XXX                                                    XXX                                                            X
X                                                        X        X                              E                    X
X Z                                                      X        XXXXXXXXXXXXXXXXXXXXXXXXXXXXXXXXXXXXXXXXXXXXXXXXXXXXX
XXX                                          XXX         X                                                          ARX
X                                                        X                                                            X
X                                                      Z XXXX                                                         X
X                                  XXX                 XXX                                                            X
X                                                        X                                                            X
X                                                      Z X        XXXXXXXXXXXX                                        X
X                        XXX                           XXX                                                            X
X                                                        X                                                            X
X                                                        X                          XXXXXXXXXXXX                   XXXX
XXXXXXXXXXXXXXXXXX                                       X                                                         X  X
X                                                        X                                                       XXX  X
X Z                                                      X                                                            X
XXX                     XXXXXXXXXXXXXXXXX                X                   XXXXXXXXXXXXXXXXXXX                      X
X                                                        X                         X           X                      X
X Z                                                     RX                         X           X               E      X
XXX                                           XXXXXXXXXXXXXXXXXXXXXXXX             X           XXXXXXXXXXXXXXXXXXXXXXXX
X                                                        X                         X               P                  X
X                                                        X                  XXXXXXXX               P                  X
X                                       X                X                                         P                  X
X                                      XX                X                                         P               C  X
X                                     XXX               AX                     E                   P                  X
XXXXXXXXXXXXXXXXXXXXXXXXXXXXXXXXXXXXXXXXXXXXXXXXXXXXXXXXXXXXXXXXXXXXXXXXXXXXXXXXXXXXXXXXXXXXXXXXXXXXXXXXXXXXXXXXXXXXXXX